1111111111
1000000001
1000000001
1000000001
1000000001
1000000001
1000000001
1000000001
1000000001
1000000001
1010000001
1010000001
1010000001
10100000$1
1111111111